#######################################################
#.....................................................#
#.......#............#####............#####...........#
#.......#................#................#...........#
#.......#................#................#...........#
#.......#............#####............#####...........#
#.......#............#....................#...........#
#.......#............#....................#...........#
#.......#............#####............#####...........#
#......%..............%................%..............#
#.....................................................#
#.....................................................#
#...###################################################
#%..#
#...#
#...#
#####