###############################################################################################
#..............................# .........................#............................#......#
#..............................#..........................#..........#########.........#......#
#............................................#............#..................#.........#......#
#..........####################..............#............#..................#......#......#..#
#.............................#..............#............#..........#.......##################
#.............................#..............#............#..........#........................#
#####################.........#############################..........#........................#
#.........#...................#...........................#..........#........................#
#.........#...................#...........................#..........################.........#
#.........#...................#...........#########.......#.........................#.........#
#.........#....#####.....######...........#...............#.........................#.........#
#.........................................#...............#.........................#.........#
#.........................................#....###############################......#.........#
###############################...........#.........................#...............#.........#
#.................#.......................#.........................#...............#.........#
#.....#...........#.......................#.........................#......####################
#.....#...........#.......###########################################......#..................#
#.....#...........#........................................................#..................#
#.....#...........#...#########################.....########################..............#...#
#.....#...........#...#.......................#......................................#....#...#
#.....#...........#...#..........###..........#......................................#....#...#
#.....#...............#..........###. ........#......................................#....#...#
#.....#######.........#..........###..........#......................................#....#...#
#...........#.........#.......................########################################....#...#
#...........#......................#..........#...........................#...............#...#
#...........#......................#..........#...........................#............... ...#
#...........#......................#..........#...........................#......########.....#
########....###################################..........#................#......#............#
#......#....#............................................#.......................#............#
#......#....#............................................#.......................#............#
#......#....#..........###########################################################............#
#......#....#..........................#.................#%...................................#
#......#....#................#.........#.........#.......#...................#.........#......#
#...........#................#...................#.......#...................#.........#......#
###############################################################################################
