#############################################################################
#...........................................................................#
#...........................................................................#
#....####..#####..#.....#..#........#...#...#####.....#..###..#.......#.....#
#....#.....#...#..#.....#..#........#..#...#.....#.......#.#..#.......#.....#
#....#.....#...#..#.....#..#........#.#....#.....#....#..###..#.....#####...#
#....####..#...#..#.....#..#..####..##.....#.....#....#....#..####....#.....#
#.......#..#...#..#.....#..#........#.#....#.....#....#....#..#..#....#.....#
#.......#..#...#..#.....#..#........#..#...#.....#....#..#.#..#..#....#.#...#
#....####..#####...#####...#........#...#..#.....#....#..###..#..#....###...#
#...........................................................................#
#...........................................................................#
#############################################################################